


NO textures/north.xpm



SO textures/south.xpm    




          WE         textures/west.xpm				



EA textures/east.xpm                                          



 F         0,153,262



C 153,102,0



1111111111
10N0000001
1010001001
1010010001
1001010001
1001010001
1111111111