

  NO    textures/north.xpm 										       	



SO     textures/south.xpm


WE         textures/west.xpm



					EA 		textures/east.xpm		

         F 0,153,255                   



C 153,102,0







	
 111111111111111111111
 10N000000100000000001
 101000100101111111101
 101001000100000011011
 100101000000000011011
 100101000111111111011
 111111111111111111111