


NO textures/north.xpm



SO textures/south.xpm    




          WE         textures/west.xpm



EA textures/east.xpm



 F         0,153,255



C 153,102,0




11111
10N001
111101
111101
111111